********************
*XXXXXXXXX*XXXXXXXXX
*********X*********X
*XXX*XXXXXXXXXXX*X*X
***X***********X*X*X
*XXX*XXX*XXX*X*X*X*X
***X***X***X*X*X*X*X
*X*XXX*X*X*XXXXXXXXX
*X***X*X*X*********X
*XXX*X*X*XXXXXXXXX*X
***X*X*X*********X*X
*XXX*X*XXXXX*XXXXXXX
***X*X*****X*******X
*XXX*X*XXX*XXXXX*X*X
***X*X***X*****X*X*X
*X*X*XXX*XXX*X*XXXXX
*X*X***X***X*X*****X
*XXXXX*XXX*XXXXXXX*X
*****X***X*******X*X
*XXXXXXXXXXXXXXXXX**